9
12
7 9 6 6 6 6 6 6 6 6 9 5
1 9 0 0 0 0 0 0 0 0 9 4
1 10 8 8 8 8 13 0 0 0 9 4
1 0 0 0 0 0 9 0 0 0 9 4
1 0 0 0 0 0 9 0 0 0 9 4
1 12 8 8 8 8 11 0 0 0 9 4
1 9 0 0 0 0 0 0 0 0 9 4
1 9 0 0 0 0 0 0 0 0 9 4
2 10 8 8 8 8 8 8 8 8 11 3

